┌───────────────────────────────────────────────────────────────────┐
│                                                                   │
│               ┌──────────────────┐                                │
│               │┼┼┼┼┼┼┼┼┼┼┼┼┼┼┼┼┼┼│                                │
│               │┼┼┼┼┼┼┼┼┼┼┼┼┼┼┼┼┼┼│                                │
│               │┼┼┼┼┼┼┼┼┼┼┼┼┼┼┼┼┼┼│                                │
│               └──────────────────┘                                │
│                                                                   │
│                                                                   │
│                                                                   │
│  ┌──────────────────────────────────────────────────────────────┐ │
│  │┼┼┼┼┼┼┼┼┼┼┼┼┼┼┼┼┼┼┼┼┼┼┼┼┼┼┼┼┼┼┼┼┼┼┼┼┼┼┼┼┼┼┼┼┼┼┼┼┼┼┼┼┼┼┼┼┼┼┼┼┼┼│ │
│  │┼┼┼┼┼┼┼┼┼┼┼┼┼┼┼┼┼┼┼┼┼┼┼┼┼┼┼┼┼┼┼┼┼┼┼┼┼┼┼┼┼┼┼┼┼┼┼┼┼┼┼┼┼┼┼┼┼┼┼┼┼┼│ │
│  │┼┼┼┼┼┼┼┼┼┼┼┼┼┼┼┼┼┼┼┼┼┼┼┼┼┼┼┼┼┼┼┼┼┼┼┼┼┼┼┼┼┼┼┼┼┼┼┼┼┼┼┼┼┼┼┼┼┼┼┼┼┼│ │
│  │┼┼┼┼┼┼┼┼┼┼┼┼┼┼┼┼┼┼┼┼┼┼┼┼┼┼┼┼┼┼┼┼┼┼┼┼┼┼┼┼┼┼┼┼┼┼┼┼┼┼┼┼┼┼┼┼┼┼┼┼┼┼│ │
│  │┼┼┼┼┼┼┼┼┼┼┼┼┼┼┼┼┼┼┼┼┼┼┼┼┼┼┼┼┼┼┼┼┼┼┼┼┼┼┼┼┼┼┼┼┼┼┼┼┼┼┼┼┼┼┼┼┼┼┼┼┼┼│ │
│  └──────────────────────────────────────────────────────────────┘ │
│                                                                   │
│                                                                   │
│                                                                   │
│                                                                   │
│     ┌─────────┐                      ┌───────────┐                │
│     │┼┼┼┼┼┼┼┼┼│                      │           │                │
│     │┼┼┼┼┼┼┼┼┼│                      │           │                │
│     │┼┼┼┼┼┼┼┼┼│                      │           │                │
│     │┼┼┼┼┼┼┼┼┼│                      │           │                │
│     │┼┼┼┼┼┼┼┼┼│                      └───────────┘                │
│     └─────────┘                                                   │
│                                                                   │
│                                                                   │
└───────────────────────────────────────────────────────────────────┘