┌─────────────────────────────────────────────┐
│                                             │
│   0                                         │
│                                             │
└────────────────────────────────────┐        │
                                     │        │
                                     │        │
                                     │        │
                                     │        │
                                     │        │
                                     │        │
 ┌───────────────────────────────────┘        │
 │                                            │
 │                                            │
 │       ┌────────────────────────────────────┘
 │       │
 │       │
 │       │
 │       │
 │       │
 │       │
 │       │
 │       │
 │       │
 │       │
 │       │
 │       │
 └───────┘