┌─────────────────────────────────────────────┐
│                                             │
│                                             │
│                                             │
└────────────────────────────────────┐        │
                                     │        │
                                     │        │
                                     │        │
                                     │        │
                                     │        │
                                     │        │
 ┌───────────────────────────────────┘        │
 │                                            │
 │                                            │
 │    0  ┌────────────────────────────────────┘
 │    x  │
 │       │
 └───────┘